###################
#C#### #####    ###
# #### ##### ## ###
# #### ##### ## ###
# ####       ## ###
#      ##### ##   M
###################