 ##################
 C#### #####    ###
  #### ##### ## ###
  #### ##### ## ###
  ####       ## ###
       ##### ##   M
###################