###################
# #### #####    ###
# #### ##### ## ###
# #### ##### ## ###
# ####       ## ###
#      ##### ##    
###################