C    ##   ##
 #          
##         #
# #        #
  ###    # #
  #         
###    ##   
###         
 ###      ##
####  # ### 
 ####       
 #M    #    