#####################
#C                  #
#                   #
#                   #
#                   #
#         M         #
#                   #
#                   #
#                   #
#####################