#########################   #
 #    ## ##         ###   ##M
 C# # #   # ####### # # # #  
 ## # # # # #     # # # ### #
 #  # # # # # ###   # # ### #
 # #  # # # # ####### # #   #
 # # #  # # # ######  # # ###
 # # # #  # # ######  # # ###
 # # # # #  # ####### # #  ##
 # # # # # #  ######  # ##  #
   #   #   #                #
#############################