#########################    
 #C   ## ##          ##   ##M
 C# # #   # ####### # # # # #
 ## # # # # #     # # # ### #
 #  # # # # # ###   # # ### #
 # #  # # # # ####### # #   #
 # # #  # # # #C   #  # # ###
 # # # #  # # #### #  # # ###
 # # # # #  # # ## ## # #  ##
 # # # # # #  # ## #  # ##  #
   #   #   #                #
#############################