###################
#C####C#####    ###
# #### ##### ## ###
# #### ##### ## ###
# ####       ## ###
#      ##### ##   M
###################