##########  # ##  #######
####### #    ###    ### #
####   ##    #   #       
#  #        # #  ##      
#   #       #   #        
 ##        #  ##       # 
 ##    ##      #      #  
 ##      # # #    ##     
 # #    ##         #    #
##        #      #      #
##           C  #  ##   #
      #############     #
  #                    ##
#     #          #    # #
# #           #     ## ##
##      #        #      #
  #            #         
 #   #           #    # #
#  # #   M      #     # #
#       ##  #      # # # 
   # #                   
##       ##    ##  # ##  
###   # #    ##      ### 
# # #    # #   ##   #####
##            # #  ### ##