#######################################################
#                                                     #
# ################################################### #
# #                                                 # #
# # ############################################### # #
#     #                                             #  
################### ####################### ##########M
#                 #              #                    #
################################   ################## #
#                              ###################### #
# ############################                        #
#C#####################################################
#######################################################