###################
#C  ## #####    ###
# #### ##### ######
# #### ##### ## ###
# ####       ## ###
#      ##### ##   M
###################