C###################
 ###################
 ###################
 ###################
 ###################
 ########    #######
 ######   ##    ####
 #####  #######  ###
 ##### ##    ### ###
 ##### #  ## ### ###
 ##### #  ##M### ###
 ##### ##  ##### ###
 ##### ###     # ###
 #####  ######   ###
 ######      #######
 ########### #######
 ########### #######
 ########### #######
 ########### #######
                   #