###################
#C  ## #####    ###
# #### ##### ## ###
# #### ##### ## ###
# ####       ## ###
#      ##### ##   M
###################